0	1
http	co
jet	blue
quick	reply
flying	experience
quick	response
great	you
clapping_hands	clapping_hands
direct	flights
amazing	jetblue
customer	service
super	smooth
rt	fleet
fleet	fleek
fleek	http
beach	airport
blue_circle	blue_circle
smiling_face_with_smiling_eyes	smiling_face_with_smiling_eyes
blue_heart	blue_heart
excited	time
ok_hand	ok_hand
free	wifi
flyfi	http
safety	first
smiling_face_with_heart	eyes
eyes	smiling_face_with_heart
fingers	crossed
glad	hear
excellent	customer
wait	travel
thumbs_up	thumbs_up
booking	problems
travel	business
favorite	airline
top	notch
social	media
loudly_crying_face	loudly_crying_face
https	co
prompt	response
co	dbcvepn5qc
bluemanity	corevalues
corevalues	passion
passion	aerojobmarket
dm	confirmation
bos	sfo
taking	off
blue	makes
amazing	customer
definitely	will
bos	mco
late	flightr
monday	night
smiling_face_with_smiling_eyes	airplane
appreciate	prompt
hot	tea
san	francisco
business	traveler
airplane	airplane
vegas	gorgeous
dca	sju
makes	happy
amp	jfk
star	star
